........
....tt..
.....t..
........
........
..t.....
.s.t....