........
....tt..
.....t..
........
.b......
..t.....
.s.t....