........
....tt..
.....t..
........
........
..tt....
........